1111111111111
1001000000C01
1000P11111001
10001100E0011
1111111111111